iX pour Bistro	Quebec City	$$$$
Laurie Raphael 	Quebec City	$$$$
Bachir	Quebec City	$
Paillard	Quebec City	$
La Pizzaio	Quebec City	$$
Les Sales Gosses	Quebec City	$$$
SSS Restaurant	Quebec City	$$
Bello Ristorante	Quebec City	$$$
Alta Bistro	Whistler	$$$$
Araxi Restaurant	Whistler	$$$$
Peaked Pies	Whistler	$
Splitz Grill	Whistler	$
Creekbread	Whistler	$$
Elements	Whistler	$$$
Tacos La Cantina	Whistler	$
Le Crocodile 	Vancouver	$$$$
Meat & Bread	Vancouver	$
Japadog	Vancouver	$
Jam Café YVR	Vancouver	$$
Bauhaus Restaurant	Vancouver	$$$$
AnnaLena	Vancouver	$$$
Café Medina	Vancouver	$$
Salmon n'Bannock	Vancouver	$$$
